Information Subject:

Gardening Websites:

The Old Farmer's Almanac - www.almanac.com/gardening
Better Homes & Gardens - www.bhg.com/gardening
Gardeners' World - www.gardenersworld.com
Fine Gardening - www.finegardening.com
Garden Design - www.gardendesign.com
National Gardening Association - www.garden.org
Royal Horticultural Society - www.rhs.org.uk
Gardenista - www.gardenista.com
Houzz - Gardening - www.houzz.com/gardening
Gardening Know How - www.gardeningknowhow.com
The Spruce - Gardening - www.thespruce.com/gardening-4127779
Mother Earth News - Gardening - www.motherearthnews.com/organic-gardening
Backyard Gardener - www.backyardgardener.com
American Horticultural Society - www.ahsgardening.org
Dave's Garden - www.davesgarden.com
BBC Gardening - www.bbc.co.uk/gardening
Gardens Illustrated - www.gardensillustrated.com
Organic Gardening - www.organicgardening.com
The Garden Helper - www.thegardenhelper.com
GardenWeb - www.gardenweb.com
Epic Gardening - www.epicgardening.com
You Grow Girl - www.yougrowgirl.com
Growing With Plants - www.growingwithplants.com
Planet Natural - www.planetnatural.com/garden
Home & Garden Information Center - www.hgic.clemson.edu
Gardener's Supply Company - www.gardeners.com
Sunset - Gardening - www.sunset.com/garden
Horticulture Magazine - www.hortmag.com
The National Gardening Association - www.garden.org
Greenhouse Megastore - www.greenhousemegastore.com
Garden Web - Houzz - www.gardenweb.com
Burpee - www.burpee.com
Johnny's Selected Seeds - www.johnnyseeds.com
Territorial Seed Company - www.territorialseed.com
Park Seed - www.parkseed.com
Seeds of Change - www.seedsofchange.com
Botanical Interests - www.botanicalinterests.com
Baker Creek Heirloom Seeds - www.rareseeds.com
Seed Savers Exchange - www.seedsavers.org
Renee's Garden - www.reneesgarden.com
Annie's Annuals - www.anniesannuals.com
White Flower Farm - www.whiteflowerfarm.com
Bluestone Perennials - www.bluestoneperennials.com
American Meadows - www.americanmeadows.com
High Country Gardens - www.highcountrygardens.com
Brent and Becky's Bulbs - www.brentandbeckysbulbs.com
Dutch Gardens - www.dutchgardens.com
Spring Hill Nurseries - www.springhillnursery.com
Wayside Gardens - www.waysidegardens.com
Gardener's Edge - www.gardenersedge.com
Gardening Express - www.gardeningexpress.co.uk
The English Garden - www.theenglishgarden.co.uk
BBC Gardeners' World Magazine - www.gardenersworld.com/magazine
Urban Gardeners Republic - www.urbangardenersrepublic.com
Rodale's Organic Life - www.rodalesorganiclife.com/garden
Patio Garden Life - www.patiogardenlife.com
Organic Authority - www.organicauthority.com/garden
GrowVeg - www.growveg.com
A Way to Garden - www.awaytogarden.com
The Micro Gardener - www.themicrogardener.com
The Horticult - www.thehorticult.com
Chiot's Run - www.chiotsrun.com
Plant Care Today - www.plantcaretoday.com
Mr. Brown Thumb - www.mrbrownthumb.com
The Gardening Cook - www.thegardeningcook.com
Garden Betty - www.gardenbetty.com
Lovely Greens - www.lovelygreens.com
Creative Vegetable Gardener - www.creativevegetablegardener.com
The Middle-Sized Garden - www.themiddlesizedgarden.co.uk
Get Busy Gardening - www.getbusygardening.com
Life on the Balcony - www.lifeonthebalcony.com
Urban Organic Gardener - www.urbanorganicgardener.com
Fresh Eggs Daily - www.fresheggsdaily.blog
Frugal Family Home - www.frugalfamilyhome.com
Attainable Sustainable - www.attainable-sustainable.net
Garden Therapy - www.gardentherapy.ca
Home for the Harvest - www.homefortheharvest.com
DIY Garden - www.diygarden.co.uk
Garden Betty - www.gardenbetty.com
Lazy Garden - www.lazy-gardens.com
Country Living - Gardening - www.countryliving.com/gardening
Alys Fowler - www.alysfowler.com
Digging - www.penick.net/digging
Funky Junk Interiors - www.funkyjunkinteriors.net
Pith & Vigor - www.pithandvigor.com
The Martha Blog - www.themarthablog.com
Seasonal Wisdom - www.seasonalwisdom.com
Little Veggie Patch Co. - www.littleveggiepatchco.com.au
Kitchen Gardeners International - www.kgi.org
Growing A Greener World - www.growingagreenerworld.com
Urban Garden Casual - www.urbangardencasual.com
Nourishing Pursuits - www.nourishingpursuits.com
Square Foot Gardening - www.squarefootgardening.org
Home Grown Edible Landscaping - www.homegrownediblelandscaping.com
Grow a Good Life - www.growagoodlife.com
Grit - Rural American Know-How - www.grit.com/gardening
Our Stoney Acres - www.ourstoneyacres.com
Fiskars - Gardening - www.fiskars.com/en-us/gardening
Bonnie Plants - www.bonnieplants.com
The Seed Collection - www.theseedcollection.com.au

Gardening Links:

